|==============|
|              |
|  <-~--->     |
|           ^  |
|           /  |
|           /  |
|        ~~ ,  |
|        ~~    |
|        ~     |
|==============|
