[==]     [=====]
      ?         
      | ~      ?
?====]   [=]  ~.
|      ~        
| [==]   [===== 
.    [= =]      
 #~             
                
  #       [====]
