[==]     [=====]
      ?         
      | ~      ?
?====]   [=]  ~.
|      ~       ^
| [==]   [=====/
.    [= =]     ,
 #~             
                
  #       [====]
